# My awesome software list

- RSSHub - is an open source, easy to use, and extensible RSS feed aggregator
- fd - A simple, fast and user-friendly alternative to 'find'.
- parallel - Build and execute shell command lines from standard input in parallel
- z - z is the new j, yo
- btop++ - resource monitor
- progress - Coreutils Progress Viewer
- ncdu - NCurses Disk Usage
- ChooseALicense-cli - Bring http://choosealicense.com to your terminal.
- youga - YOGA Image Optimizer
- euporie - terminal app for running and editing Jupyter notebooks.
- xkcd cli tool - Get your daily dose of xkcd directly from the terminal!
- lsix - Like "ls", but for images.
- reredirect - A tool to dynamically redirect outputs of a running program
- howdoi - Instant coding answers via the command line
- ventoy - Open-Source Software Ventoy - A new bootable USB solution.
- GitHub CLI - gh, pull requests, issues, and other GitHub concepts to the terminal next to where you are already working with git and your code.
- GLab - A GitLab CLI Tool, work with issues, merge requests, watch running pipelines directly from your CLI among other features.
- wtwitch - A terminal program for Twitch
- ansible - Simple IT Automation
- fzf - general-purpose command-line fuzzy finder
- ripgrep -  recursively searches the current directory for a regex pattern
- pandoc - swiss-army knife to convert markup format files
- jq - jq is like sed for JSON data
- tesseract - command-line OCR engine
- sqlite - a small, fast, self-contained, high-reliability, full-featured, SQL database engine

- wget - GNU Wget is a free software package for retrieving files using HTTP, HTTPS, FTP and FTPS
- rclone - command-line program to manage files on cloud storage
- rsync - fast and extraordinarily versatile file copying tool
- p7zip/7z - file archiver with a high compression ratio
- bitlbee - brings IM (instant messaging) to IRC clients
- ripcord - desktop chat client
- telegram is a cloud-based mobile and desktop messaging app
- pass - standard unix password manager
- syncthing - is a continuous file synchronization program
- gpg (gnupg) - encrypt and sign your data and communications
- ledger - Command-Line Accounting
- visidata - interactive multitool for tabular data
- sc-im - curses based spreadsheet calculator
- ClipIt - Lightweight GTK+ Clipboard Manager

- firefox - free web browser backed by Mozilla
  - treestyletabs
  - vimium
- blender - 3D computer graphics software toolset
- solvespace - parametric 3d CAD tool
- godot - open-source game engine
- krita - raster graphics editor
- gimp - raster graphics editor
- inkscape + inkscape-open-symbols - vector graphics editor
- kdenlive - video editing program
- qbittorent-nox - command line Bittorrent client written in C++ / Qt
- darktable - photography workflow application and raw developer
- simplescreenrecorder - record programs and games
- QStarDict - free dictionary program written using Qt
- crow translate -  simple and lightweight translator written in C++ / Qt (use external API's)
- anki - anki is a program which makes remembering things easy
- maim - utility that takes screenshots of your desktop
- ffmpeg - cross-platform solution to record, convert and stream audio and video
- imagemagic - create, edit, compose, or convert digital images
- zeal - offline documentation browser for software developers
- zotero + zotero connector - collect, organize, annotate, cite, and share research (books, media, etc)

- alacritty - modern terminal emulator
- yay - AUR Helper
- borg -  deduplicating backup program
- qalc + rofi-calc - multi-purpose cross-platform desktop calculator

- nnn - full-featured terminal file manager
- zathura - document viewer
- htop - cross-platform interactive process viewer
- ventoy -  tool to create bootable USB drive
- parted + gparted -  managing your disk partitions

- libvrt + virt-manager - managing virtual machines
- wireguard - simple yet fast and modern VPN
- remmina - remote access screen and file sharing

- mpv - media player for the command line
- mpd + mpc + beets + ncmcpp - system to play and manage audio
- ytfzf - POSIX script that helps you find Youtube videos

- steam - platform for playing, discussing, and creating games.
- dosbox -  an x86 emulator with DOS
- RetroArch - frontend for emulators, game engines and media players
- PCSX2 - Playstation 2 Emulator
- RPCS3 - PlayStation 3 emulator and debugger
- Wine - compatibility layer capable of running Windows applications
- blanket - listen to different sounds

- i3 - dynamic tiling window manager
  - polybar - beautiful and highly customizable status bars
  - dunst - configurable and lightweight notification daemon
  - rofi - a window switcher, Application launcher and dmenu replacement.
    - rofi-pass - script to handle Simple Password Store
    - rofi-buku - rofi frontend for buku bookmarks manager
